{
  "levelNumber": 9,
  "name": "Level 9",
  "legend": {
    "0": "empty",
    "1": "normal",
    "2": "strong",
    "3": "invisible"
  },
  "layout": [
    "0000000000000",
    "0000000000000",
    "0000000000000",
    "0000000000000",
    "0000002000000",
    "0001112111000",
    "0011111111100",
    "0011111111100",
    "0111111111110",
    "0111111111110",
    "0111111111110",
    "0200202020020",
    "0000002000000",
    "0000002000000",
    "0000002000000",
    "0000202000000",
    "0000222000000",
    "0000020000000",
    "0000000000000",
    "0000000000000",
    "0000000000000",
    "0000000000000",
    "0000000000000",
    "0000000000000",
    "0000000000000",
    "0000000000000",
    "0000000000000",
    "0000000000000"
  ],
  "boss": [
  ],
  "colors": [
    "0000000000000",
    "0000000000000",
    "0000000000000",
    "0000000000000",
    "0000002000000",
    "0003332666000",
    "0033355566600",
    "0033555556600",
    "0333555556660",
    "0333555556660",
    "0333555556660",
    "0200202020020",
    "0000002000000",
    "0000002000000",
    "0000002000000",
    "0000202000000",
    "0000222000000",
    "0000020000000",
    "0000000000000",
    "0000000000000",
    "0000000000000",
    "0000000000000",
    "0000000000000",
    "0000000000000",
    "0000000000000",
    "0000000000000",
    "0000000000000",
    "0000000000000"
  ]
}
