{
  "levelNumber": 2,
  "name": "Level 2",
  "legend": {
    "0": "empty",
    "1": "normal",
    "2": "strong",
    "3": "invisible"
  },
  "layout": [
    "0000000000000",
    "0000000000000",
    "1000000000000",
    "1100000000000",
    "1110000000000",
    "1111000000000",
    "1111100000000",
    "1111110000000",
    "1111111000000",
    "1111111100000",
    "1111111110000",
    "1111111111000",
    "1111111111100",
    "1111111111110",
    "2222222222221",
    "0000000000000",
    "0000000000000",
    "0000000000000",
    "0000000000000",
    "0000000000000",
    "0000000000000",
    "0000000000000",
    "0000000000000",
    "0000000000000",
    "0000000000000",
    "0000000000000",
    "0000000000000"
  ],
  "colors": [
    "0000000000000",
    "0000000000000",
    "0000000000000",
    "0100000000000",
    "0120000000000",
    "0123000000000",
    "0123400000000",
    "0123450000000",
    "0123456000000",
    "0123456700000",
    "0123456780000",
    "0123456780000",
    "0123456780100",
    "0123456780120",
    "2222222222223",
    "0000000000000",
    "0000000000000",
    "0000000000000",
    "0000000000000",
    "0000000000000",
    "0000000000000",
    "0000000000000",
    "0000000000000",
    "0000000000000",
    "0000000000000",
    "0000000000000",
    "0000000000000"
  ],
  "boss": [
    {"type":  "pyramid", "x": 200, "y":  0}
  ]
}
