{
  "levelNumber": 3,
  "name": "Level 3",
  "legend": {
    "0": "empty",
    "1": "normal",
    "2": "strong",
    "3": "invisible"
  },
  "layout": [
    "0000000000000",
    "0000000000000",
    "0000000000000",
    "1111111111111",
    "0000000000000",
    "1112222222222",
    "0000000000000",
    "1111111111111",
    "0000000000000",
    "2222222222111",
    "0000000000000",
    "1111111111111",
    "0000000000000",
    "1112222222222",
    "0000000000000",
    "1111111111111",
    "0000000000000",
    "2222222221111",
    "0000000000000",
    "0000000000000",
    "0000000000000",
    "0000000000000",
    "0000000000000",
    "0000000000000",
    "0000000000000",
    "0000000000000",
    "0000000000000",
    "0000000000000"
  ],
  "boss": [
    {"type":  "pyramid", "x": 200, "y":  0},
    {"type":  "pyramid", "x": 100, "y":  0}
  ],
  "colors": [
    "0000000000000",
    "0000000000000",
    "0000000000000",
    "0000000000000",
    "0000000000000",
    "1110000000000",
    "0000000000000",
    "2222222222222",
    "0000000000000",
    "0000000000333",
    "0000000000000",
    "4444444444444",
    "0000000000000",
    "5550000000000",
    "0000000000000",
    "6666666666666",
    "0000000000000",
    "0000000007777",
    "0000000000000",
    "0000000000000",
    "0000000000000",
    "0000000000000",
    "0000000000000",
    "0000000000000",
    "0000000000000",
    "0000000000000",
    "0000000000000",
    "0000000000000"
  ]
}
