{
  "levelNumber": 2,
  "name": "Level 2",
  "legend": {
    "0": "empty",
    "1": "normal",
    "2": "strong",
    "3": "invisible",
    "4": "explosive"
  },
  "layout": [
    "0000000000000",
    "0000000000000",
    "4000000000000",
    "1100000000000",
    "1110000000000",
    "4111000000000",
    "1111100000000",
    "1114110000000",
    "1111111000000",
    "1111111100000",
    "1411114110000",
    "1111114111000",
    "1111111141100",
    "1111411111110",
    "2222222222224",
    "0000000000000",
    "0000000000000",
    "0000000000000",
    "0000000000000",
    "0000000000000",
    "0000000000000",
    "0000000000000",
    "0000000000000",
    "0000000000000",
    "0000000000000",
    "0000000000000",
    "0000000000000",
    "0000000000000"
  ],
  "boss": [
    {"type":  "pyramid", "x": 200, "y":  0}
  ],
  "colors": [
    "0000000000000",
    "0000000000000",
    "0000000000000",
    "0100000000000",
    "0120000000000",
    "0123000000000",
    "0123400000000",
    "0123450000000",
    "0123456000000",
    "0123456700000",
    "0123456780000",
    "0123456780000",
    "0123456780100",
    "0123456780120",
    "2222222222223",
    "0000000000000",
    "0000000000000",
    "0000000000000",
    "0000000000000",
    "0000000000000",
    "0000000000000",
    "0000000000000",
    "0000000000000",
    "0000000000000",
    "0000000000000",
    "0000000000000",
    "0000000000000",
    "0000000000000"
  ]
}
