{
  "levelNumber": 2,
  "name": "Level 2",
  "legend": {
    "0": "empty",
    "1": "normal",
    "2": "strong",
    "3": "invisible"
  },
  "layout": [
    "0000000000",
    "0000000000",
    "0000000000",
    "0000000000",
    "0000000000",
    "1111111111",
    "1111111111",
    "1122222211",
    "3111111113",
    "3333333333",
    "0000000000",
    "0000000000",
    "0000000000",
    "0000000000",
    "0000000000",
    "0000000000",
    "0000000000",
    "0000000000",
    "0000000000",
    "0000000000",
    "0000000000",
    "0000000000",
    "0000000000",
    "0000000000",
    "0000000000",
    "0000000000"

  ]
}
