{
  "levelNumber": 5,
  "name": "Level 5",
  "legend": {
    "0": "empty",
    "1": "normal",
    "2": "strong",
    "3": "invisible"
  },
  "layout": [
    "0000000000000",
    "0000000000000",
    "0002000002000",
    "0002000002000",
    "0000200020000",
    "0000200020000",
    "0001111111000",
    "0001111111000",
    "0011111111100",
    "0011111111100",
    "0111111111110",
    "0111111111110",
    "0111111111110",
    "0101111111010",
    "0101000001010",
    "0101000001010",
    "0000110110000",
    "0000110110000",
    "0000000000000",
    "0000000000000",
    "0000000000000",
    "0000000000000",
    "0000000000000",
    "0000000000000",
    "0000000000000",
    "0000000000000"
  ],
  "colors": [
    "0000000000000",
    "0000000000000",
    "0002000002000",
    "0002000002000",
    "0000200020000",
    "0000200020000",
    "0001111111000",
    "0001111111000",
    "0011611161100",
    "0011611161100",
    "0111111111110",
    "0111111111110",
    "0111111111110",
    "0101111111010",
    "0101000001010",
    "0101000001010",
    "0000110110000",
    "0000110110000",
    "0000000000000",
    "0000000000000",
    "0000000000000",
    "0000000000000",
    "0000000000000",
    "0000000000000",
    "0000000000000",
    "0000000000000"
  ]
}
