{
  "levelNumber": 8,
  "name": "Level 8",
  "legend": {
    "0": "empty",
    "1": "normal",
    "2": "strong",
    "3": "invisible"
  },
  "layout": [
    "0000000000000",
    "0000000000000",
    "0000000000000",
    "0000000000000",
    "0111111111110",
    "0100000000010",
    "0101111111010",
    "0101000001010",
    "0101011101010",
    "0101010101010",
    "0101011101010",
    "0101000001010",
    "0101111111010",
    "0100000000010",
    "0111111111110",
    "0000000000000",
    "0000000000000",
    "0000000000000",
    "0000000000000",
    "0000000000000",
    "0000000000000",
    "0000000000000",
    "0000000000000",
    "0000000000000",
    "0000000000000",
    "0000000000000",
    "0000000000000",
    "0000000000000"
  ],
  "boss": [
  ],
  "colors": [
    "0000000000000",
    "0000000000000",
    "0000000000000",
    "0000000000000",
    "0123713278631",
    "0128726376541",
    "1704881610813",
    "1487640142021",
    "0024782340023",
    "2374532602348",
    "0302324764323",
    "0032430224230",
    "0023327632623",
    "2363200236333",
    "3736634002376",
    "0000000000000",
    "0000000000000",
    "0000000000000",
    "0000000000000",
    "0000000000000",
    "0000000000000",
    "0000000000000",
    "0000000000000",
    "0000000000000",
    "0000000000000",
    "0000000000000",
    "0000000000000",
    "0000000000000"
  ]
}
