{
  "levelNumber": 8,
  "name": "Level 8",
  "legend": {
    "0": "empty",
    "1": "normal",
    "2": "strong",
    "3": "invisible"
  },
  "layout": [
    "0000000000000",
    "0000000000000",
    "0000000000000",
    "0000000000000",
    "0333333333330",
    "0300000000030",
    "0303333333030",
    "0303000003030",
    "0303033303030",
    "0303030303030",
    "0303033303030",
    "0303000003030",
    "0303333333030",
    "0300000000030",
    "0333333333330",
    "0000000000000",
    "0000000000000",
    "0000000000000",
    "0000000000000",
    "0000000000000",
    "0000000000000",
    "0000000000000",
    "0000000000000",
    "0000000000000",
    "0000000000000",
    "0000000000000",
    "0000000000000",
    "0000000000000"
  ],
  "boss": [
  ],
  "colors": [
    "0000000000000",
    "0000000000000",
    "0000000000000",
    "0000000000000",
    "0123713278631",
    "0128726376541",
    "1704881610813",
    "1487640142021",
    "0024782340023",
    "2374532602348",
    "0302324764323",
    "0032430224230",
    "0023327632623",
    "2363200236333",
    "3736634002376",
    "0000000000000",
    "0000000000000",
    "0000000000000",
    "0000000000000",
    "0000000000000",
    "0000000000000",
    "0000000000000",
    "0000000000000",
    "0000000000000",
    "0000000000000",
    "0000000000000",
    "0000000000000",
    "0000000000000"
  ]
}
