{
  "levelNumber": 7,
  "name": "Level 7",
  "legend": {
    "0": "empty",
    "1": "normal",
    "2": "strong",
    "3": "invisible"
  },
  "boss": [
    {"type":  "pyramid", "x": 200, "y":  0},
    {"type":  "pyramid", "x": 100, "y":  0}
  ],
  "layout": [
    "0200000000000",
    "0000000000000",
    "0000000000000",
    "0000000000000",
    "0200000000000",
    "0200000100000",
    "0200001110000",
    "0200011111000",
    "0200111111100",
    "0201111111110",
    "0200111111100",
    "0200011111000",
    "0200001110000",
    "0200000100000",
    "0200000000000",
    "0200000000000",
    "0200000000000",
    "0222222222222",
    "0000000000000",
    "0000000000000",
    "0000000000000",
    "0000000000000",
    "0000000000000",
    "0000000000000",
    "0000000000000",
    "0000000000000",
    "0000000000000",
    "0000000000000"
  ],
  "colors": [
    "0200000000000",
    "0000000000000",
    "0000000000000",
    "0200000000000",
    "0200000000000",
    "0200000000000",
    "0200000100000",
    "0200001210000",
    "0200012321000",
    "0200123432100",
    "0200012321000",
    "0200001210000",
    "0200000100000",
    "0200000000000",
    "0200000000000",
    "0200000000000",
    "0200000000000",
    "0222222222222",
    "0000000000000",
    "0000000000000",
    "0000000000000",
    "0000000000000",
    "0000000000000",
    "0000000000000",
    "0000000000000",
    "0000000000000",
    "0000000000000",
    "0000000000000"
  ]
}
