{
  "levelNumber": 1,
  "name": "Level 1",
  "legend": {
    "0": "empty",
    "1": "normal",
    "2": "strong",
    "3": "invisible",
    "4": "explosive"
  },
  "layout": [
    "0000000000000",
    "0000000000000",
    "0000000000000",
    "0000000000000",
    "1111111111111",
    "1111111111111",
    "1111111111111",
    "1111111111111",
    "1111111111111",
    "1111114111111",
    "0000000000000",
    "0000000000000",
    "0000000000000",
    "0000000000000",
    "0000000000000",
    "0000000000000",
    "0000000000000",
    "0000000000000",
    "0000000000000",
    "0000000000000",
    "0000000000000",
    "0000000000000",
    "0000000000000",
    "0000000000000",
    "0000000000000",
    "0000000000000",
    "0000000000000",
    "0000000000000"
  ],
  "boss": [
    {"type":  "pyramid", "x": 200, "y":  0}
  ],
  "colors": [
    "0000000000000",
    "0000000000000",
    "0000000000000",
    "0000000000000",
    "0000000000000",
    "1111111111111",
    "2222222222222",
    "3333333333333",
    "4444444444444",
    "5555555555555",
    "0000000000000",
    "0000000000000",
    "0000000000000",
    "0000000000000",
    "0000000000000",
    "0000000000000",
    "0000000000000",
    "0000000000000",
    "0000000000000",
    "0000000000000",
    "0000000000000",
    "0000000000000",
    "0000000000000",
    "0000000000000",
    "0000000000000",
    "0000000000000",
    "0000000000000",
    "0000000000000"
  ]
}
