{
  "levelNumber": 1,
  "name": "Level 1",
  "legend": {
    "0": "empty",
    "1": "normal",
    "2": "strong",
    "3": "invisible"
  },
  "layout": [
    "0000000000",
    "0000000000",
    "0000000000",
    "0000000000",
    "0000000000",
    "1111111111",
    "1111111111",
    "0000000000",
    "1122222211",
    "0000000000",
    "0000000000",
    "0000000000",
    "0000000000",
    "0000000000",
    "0000000000",
    "0000000000",
    "0000000000",
    "0000000000",
    "0000000000",
    "0000000000",
    "0000000000",
    "0000000000",
    "0000000000",
    "0000000000",
    "0000000000",
    "0000000000",
    "0000000000"
  ],
  "boss": [
    {"type":  "pyramid", "x": 200, "y":  0}
  ]
}
