{
  "levelNumber": 9,
  "name": "Level 9",
  "legend": {
    "0": "empty",
    "1": "normal",
    "2": "strong",
    "3": "invisible"
  },
  "layout": [
    "0000000000000",
    "0000000000000",
    "0000000000000",
    "0000000000000",
    "0001100011000",
    "0011110111100",
    "0011110111100",
    "0111122111110",
    "0111122111110",
    "0111112211110",
    "0111112211110",
    "0011122111100",
    "0011122111100",
    "0001112211000",
    "0001112211000",
    "0000122110000",
    "0000022100000",
    "0000002000000",
    "0000000000000",
    "0000000000000",
    "0000000000000",
    "0000000000000",
    "0000000000000",
    "0000000000000",
    "0000000000000",
    "0000000000000",
    "0000000000000",
    "0000000000000"
  ],
  "boss": [
  ],
  "colors": [
    "0000000000000",
    "0000000000000",
    "0000000000000",
    "0000000000000",
    "6666666666666",
    "6666666666666",
    "6666666666666",
    "6666666666666",
    "6666666666666",
    "6666666666666",
    "6666666666666",
    "6666666666666",
    "6666666666666",
    "6666666666666",
    "6666666666666",
    "6666666666666",
    "6666666666666",
    "6666666666666",
    "0000000000000",
    "0000000000000",
    "0000000000000",
    "0000000000000",
    "0000000000000",
    "0000000000000",
    "0000000000000",
    "0000000000000",
    "0000000000000",
    "0000000000000"
  ]
}
